tut2_map = [[ 3, 3, 3, 3, 3,16, 3,16, 3,00,00,00,00,00,00,00,00,00,00,00,00,00,00,00,00,00,00,00,00,00,00,00,00,00,00,00,00,00,00,00,00,00,00,00,00],
            [ 3, 3, 3, 3,16, 3, 3,16, 3,00,00,00,00,00,00,00,00,00,00,00,00,00,00,00,00,00,00,00,00,00,00,00,00,00,00,00,00,00,00,00,00,00,00,00,00],
            [ 3, 3, 3, 3,16, 3,16,16, 3,00,00,00,00,00,00,00,00,00,00,00,00,00,00,00,00,00,00,00,00,00,00,00,00,00,00,00,00,00,00,00,00,00,00,00,00],
            [ 3, 3, 3, 3, 3, 3, 3, 3, 3,00,00,00,00,00,00,00,00,00,00,00,00,00,00,00,00,00,00,00,00,00,00,00,00,00,00,00,00,00,00,00,00,00, 9,00,00],
            [ 3, 3, 3, 3,16, 3, 3, 3, 3,00,00,00,00,00,00,00,00,00,00,00,00,00,00,00,00,00,00,00,00,00,00,00, 3,00,00,00,00,00,00,00,00,00,00,00,00],
            [ 3, 3, 3, 3, 3, 3, 3, 3, 3,00,00,00,00,00,00,00,00,00,00,00,00,00,00,00,00,00,00,00,00,00,00,00,16,00,00,00,00,00,00,00,00,00,00,00,00],
            [ 3, 3, 3, 3, 3, 3,16, 3, 3,00,00,00,00,00,00,00,00,00,00,00,00,00,00,00,00,00,00,00,00,00,00, 3,16, 3, 3,16,16, 3, 3, 3, 3, 3,16, 3,16],
            [ 3, 3,16,16,16, 3, 3,16, 3,00,00,00,00,00,00,00,00,00,00,00,00,00,00,00,00,00,00,00,16,16,00,00,00,00,00,00,00,00,00,00,00,00,00,00,16],
            [ 3, 3, 3,16, 3,16, 3, 3, 3,00,00,00,00,00,00,00,00,00,00,00,00,00,00,00,00,16,00,16,16,16,00,00,00,00,00,00,00,00,00,00,00,00,00,15, 3],
            [ 3, 3, 3, 3, 3, 3, 3,16, 3,00,00,00,00,00,00,00,00,00,00,00,00,00,00,00,16,16,00,00,00,00,00,00,00,00,00,00,00,00,00,00,00,00,00,13, 3],
            [ 3, 3, 3, 3, 3,16, 3, 3, 3, 3,00,00,00, 3,16,00,00,00,00,00,00,00,00,16,16,16,00,00,00,00,00,00,00,00,00,00,00,00,00,00,00,00,00,00, 3],
            [ 3, 3, 3, 3,16, 3, 3,16, 3,16, 3, 3,16, 3,16, 3, 3,00,00,00,00,16,16, 3, 3, 3, 3, 3,16, 3,16,16, 3, 3, 3,16, 3, 3,16, 3, 3, 3, 3, 3, 3],
            [ 3, 3, 3, 3,16, 3, 3, 3, 3,16,16, 3, 3, 3,16, 3, 3,00,00,00,00, 3, 3,16, 3,16, 3, 3, 3, 3, 3, 3, 3,16,16, 3, 3,16,16, 3, 3, 3, 3, 3, 3],
            [ 3, 3, 3, 3, 3,16, 3, 3,16, 3, 3,16, 3, 3, 3, 3, 3, 5, 5, 5, 5, 3,16,16, 3, 3, 3, 3, 3, 3, 3,16, 3, 3, 3,16, 3, 3,16, 3,16,16, 3, 3, 3],
            [ 3, 3, 3, 3, 3,16, 3,16, 3, 3,16, 3, 3,16, 3, 3,16, 4, 4, 4, 4,16, 3,16,16, 3, 3,16, 3, 3,16, 3, 3, 3,16,16, 3, 3,16, 3, 3, 3,16,16, 3],
            [ 3, 3, 3, 3, 3, 3,16, 3,16, 3, 3, 3, 3, 3, 3, 3,16, 4, 4, 4, 4,16, 3,16, 3, 3,16, 3, 3, 3, 3,16,16, 3, 3, 3,16, 3, 3,16, 3,16, 3,16,16],
            [ 3, 3, 3, 3, 3,16,16, 3, 3, 3,16, 3,16, 3, 3,16, 3, 3, 3,16, 3, 3, 3,16, 3, 3, 3,16, 3, 3, 3,16, 3, 3, 3,16, 3,16, 3, 3, 3, 3,16,16, 3],
            [ 3, 3, 3, 3, 3, 3,16, 3,16, 3, 3,16, 3, 3,16, 3, 3,16, 3, 3, 3, 3,16, 3,16,16, 3, 3,16, 3, 3, 3, 3,16, 3, 3, 3,16, 3, 3,16, 3, 3, 3,16],
            [ 3, 3, 3, 3,16, 3, 3, 3, 3, 3, 3, 3,16, 3, 3, 3, 3, 3,16, 3, 3, 3,16, 3, 3,16, 3,16,16, 3, 3, 3,16, 3, 3, 3,16, 3, 3,16,16,16, 3,16,16],
            [ 3, 3, 3, 3, 3,16, 3,16,16, 3, 3, 3, 3, 3,16, 3,16, 3, 3, 3,16, 3, 3,16, 3,16, 3, 3,16, 3, 3,16,16,16, 3, 3,16, 3,16, 3, 3, 3,16, 3,16],
            [ 3, 3, 3, 3, 3, 3, 3, 3, 3,16, 3, 3, 3,16, 3, 3, 3, 3,16,16, 3, 3, 3, 3, 3, 3,16,16, 3, 3,16, 3, 3,16, 3, 3,16, 3,16, 3, 3,16, 3,16, 3],
            [ 3, 3, 3, 3, 3,16,16, 3, 3, 3,16,16, 3, 3, 3, 3, 3,16, 3, 3, 3, 3, 3, 3,16,16, 3,16, 3,16,16,16, 3, 3,16,16, 3, 3, 3,16, 3, 3, 3, 3,16],
            [ 3, 3, 3, 3, 3, 3, 3,16, 3, 3, 3, 3, 3, 3, 3, 3, 3, 3, 3, 3, 3,16,16, 3, 3, 3, 3, 3,16, 3, 3, 3,16,16, 3, 3,16, 3, 3, 3, 3, 3, 3, 3, 3]]